############################
#..........................#
#.#.#####.########.#####.#.#
#.#......................#.#
#.#.#####.########.#####.#.#
#.#.#####.########.#####.#.#
#.........###..###.........#
#.###.###.########.###.###.#
#.###.###.########.###.###.#
#.###........g.........###.#
#.###.###.########.###.###.#
#.###.###.#......#.###.###.#
#.......#.#..l...#.#.......#
#.###.#.#.#......#.#.#.###.#
#.###.#.#.########.#.#.###.#
#.....#......p.......#.....#
#.###.#.#.########.#.#.###.#
#.###.#.#.########.#.#.###.#
#.....#.#.#......#.#.#.....#
#.###.#.#.########.#.#.###.#
#.###.#.#.########.#.#.###.#
#..........................#
#.#.###.############.###.#.#
#.#.###.############.###.#.#
#.#......................#.#
#.#.#####.########.#####.#.#
#.#.#####.########.#####.#.#
#..........................#
############################