############################
#..........................#
#.#.#####.########.#####.#.#
#.#......................#.#
#.#.###.############.###.#.#
#.#.###.############.###.#.#
#...###..............###...#
#.#.###.############.###.#.#
#.#.###.############.###.#.#
#............g.............#
#.###.###.########.###.###.#
#.###.###.#......#.###.###.#
#.......#.#..l...#.#.......#
#.#.###.#.#......#.#.###.#.#
#.#.###.#.########.#.###.#.#
#.....#......p.......#.....#
#.###.#.############.#.###.#
#.###.#.############.#.###.#
#.###..................###.#
#.###.################.###.#
#.###.################.###.#
#..........................#
#.#.#####.########.#####.#.#
#.#.#####.########.#####.#.#
#..........................#
#.#.#.#.############.#.#.#.#
#.#.#.#.############.#.#.#.#
#..........................#
############################